F 128,5,10
NO ./incs/tube.xpm
SO ./incs/sakura.xpm

EA ./incs/seeds.xpm
WE ./incs/square.xpm
C 135,206,235

1111111111111
100D000000101
10000010DS001
1100100000001
1000D00000 001
1111111111111