F 128,5,10

NO ./incs/tube.xpm
SO ./incs/sakura.xpm

EA ./incs/seeds.xpm
WE ./incs/square.xpm
C 135,206,235

1111111111111
1000000010001
100000N000001
1100100001001
1000000000001
1111111111111
