 F  128,5,10
 NO  ./incs/tube.xpm
 SO  ./incs/sakura.xpm

 EA  ./incs/seeds.xpm  
 WE  ./incs/square.xpm  
   C  123,123,123   

11111111111111111111111
1000000000101000000000D
10000010000010000000001
1100100000001111D111111
100000000000D0000000001
1000000000101000000000D
10000010000010000000001
1100100000001111D111111
100000000000D0000000001
111111111D1111111111111
1000000000101000000000D
11111110000010000000001
1000000000001111D111111
100N00000000D0000000001
11111111111111111111111