F 128,5,10

NO ./incs/tube.xpm
SO ./incs/sakura.xpm

EA ./incs/seeds.xpm
WE ./incs/square.xpm
C 135,206,235

11111111111111111111111
1000000000101000000000D
100000100S0010000000001
1100100000001111D111111
100000000000D0000000001
11111111111111111111111
