F 128,5,10

NO ./incs/tube.xpm
SO ./incs/sakura.xpm

EA ./incs/seeds.xpm
WE ./incs/square.xpm
C 135,206,235

1111111111111
100D00000D10 1111111111
100000100N001
1100100000001
1000D00000001
1111111111111
