F  30,60,130
NO  ./incs/textures2/north.xpm
SO  ./incs/textures2/south.xpm

EA  ./incs/textures2/east.xpm  
WE  ./incs/textures2/west.xpm  
C  255,220,0 

1111111111       1111
110001110111      1  1
0110000001111111111111
10000000E001      1
011000000001     101
000111111111      1
