F 128,5,10

NO ./incs/tube.xpm
SO ./incs/sakura.xpm

EA ./incs/seeds.xpm
WE ./incs/square.xpm
C 135,206,235

1111111111111
100D000000101
10000010DS001
11001000000011111111111
10000000000000000000001
11111111111111111111111
