F 200,150,50

NO ./incs/tube.xpm
SO ./incs/sakura.xpm

EA ./incs/seeds.xpm
WE ./incs/square.xpm
C 255,100,5

1111111111111
1000000010001
1000000000001
110010000N001
1000000000001
1111111111111
