F  220,100,0

SO  ./incs/textures2/south.xpm
NO  ./incs/textures2/north.xpm

EA  ./incs/textures2/east.xpm
WE  ./incs/textures2/west.xpm
C  1,255,225
C  1,255,225

        1111111111111111111111111
        1000000000110000000000001
        1011000001110000000000001
        1001000000000000000000001
111111111011000001110000000000001
100000000011000001110111111111111
11110111111111011100000010001
11110111111111011101010010001
11000000110101011100000010001
10000000000000001100000010001
100000N0000000001101010010001
110000011101010111110110100111
11110111 1110101 101111000001
1111111111111111 111111111111
