F  30,60,130
NO  ./incs/textures2/north.xpm
SO  ./incs/textures2/south.xpm

EA  ./incs/textures2/east.xpm  
WE  ./incs/textures2/west.xpm  
C  255,220,0 

1111111111       1111000
110001110111      1  100
011000000111111111111100
10000000E001      10000
011000000001     10100
000111111111      10000
