F  220,100,0


SO  ./incs/textures/south.xpm



NO             ./incs/textures/north.xpm


EA  ./incs/textures/east.xpm
WE          ./incs/textures/west.xpm
C     0,255,225

        1111111111111111111111111
        1000000000110000000000001
        1011000001110000000000001
        1001000000000000000000001
111111111011000001110000000000001
100000000011000001110111111111111
11110111111111011100000010001
11110111111111011101010010001
11000000110101011100000010001
10000000000000001100000010001
10000000000000001101010010001
11000001110101011111011010N01
11110111 1110101 101111000001
1111111111111111 111111111111
